0H0H0H0H
00000000
00000000
00000000
00000000
00000000
00000000
F0000000